28 9
############################
#K                     Z  P#
#      #                   #
#      #                   #
###    #          #    #####
#D  # Z#          #        #
#                 ###      #
#                          #
############################